IPPR,age_at_entry,age_at_diag,diff_entry_diag,Taille,Appli,mean,std
4551728,-16945,20658,-37603,1.63,CRC,1.6146153846153846,0.00859337848847311
2570704,-16191,20956,-37147,1.8,CRC,1.8,
44202662,-177,5203,-5380,0.66,EVO,1.3986363636363637,0.637657744857825
1010967,-366,1204,-1570,0.5,EVO,0.9262222222222221,0.13985851436506835
5886934,-109,2405,-2514,0.72,EVO,1.2252439024390247,0.10457705068638123
14101197,-61,379,-440,0.62,EVO,0.9087755102040812,0.13686674463075202
79217370,-458,844,-1302,0.51,EVO,0.9198333333333332,0.12425359070167713
1104440,-153,912,-1065,0.55,EVO,0.8200000000000002,0.17126976771553507
14123677,-90,1305,-1395,0.07,EVO,0.490909090909091,0.3682785507046139
47136365,-122,101,-223,0.49,EVO,0.8362499999999999,0.20770428842123467
31462451,-329,2890,-3219,0.5,EVO,1.1463157894736842,0.16970438694202478


Analyse
======= 
En regard des autres données enregistrées pour le même individu :

4551728  Chelou
2570704  Une seule entrée
14123677 Très chelou
-------
1010967
79217370
1104440
=> Pas de sens, si l'on passe l'age de saisie en positif, la taille 
correspondante s'inscrit mal dans la série de valeurs du patient.  


44202662
5886934
14101197
47136365
31462451
=> Âge à la saisie a été enregistré en négatif et devrait être positif.
Patients enfants, l'âge de la première saisie est toujours < 500 jours
